^1  = RED
^2  = GREEN
^3  = YELLOW
^4  = BLUE
^5  = CYAN
^6  = PINK
^7  = WHITE
^8  = DEFAULT MAP COLOR
^9  = GREY OR DEFAULT MAP COLOR
^0  = BLACK
^;  = YALE BLUE
^:  = LIGHT YELLOW
^.  = ORANGE

Buttons / symbols can be anywhere in your name or regiment.

BUTTONS - COPY WHAT'S IN THE BRACKETS
A / X     = []
B / O     = []
X / square    = []
Y / triangle   = []
LB         = []
RB         = []
LT         = []
RT         = []
LS         = []
RS         = []
Dpad UP    = []
Dpad Left  = []
Dpad Right = []
Dpad Down  = []
Start      = [] 
Select      = []
----




SYMBOLS - COPY WHAT'S IN THE BRACKETS
----
Mouse Wheel  = [ﬂ†]
Mouse 4      = [ﬂ°]
Mouse 3      = [ﬂ¢]
Mouse Wheel/= [ﬂ£]
Mouse Wheel/= [ﬂ§]
Mouse          = [ﬂ•]
Audio          = [ﬂ¶]
Ticket       = [ﬂß]
Warning Red  = [ﬂ®]
Headshot      = [ﬂ©]
Headshot Sign= [ﬂ™]
Unlock         = [ﬂ´]
Spinny Boi     = [ﬂÆ]
Grenade      = [ﬂØ]
Left Upﬂá      = [ﬂá]
Right Up     = [ﬂà]
Left Stick   = [ﬂâ]
Right Stick  = [ﬂä]
Left Stick   = [ﬂã]
Right Stick  = [ﬂå]
Mantle         = [ﬂç]
DPAD          = [ﬂé]
Pros         = [ﬂè]
Cons         = [ﬂê]
Warning      = [ﬂë]
Double Arrow = [ﬂí]
Lock         = [ﬂî]
Cod Points      = [ﬂñ] 
Up Arrow      = [ﬂö]
Down Arrow   = [ﬂõ]
Left Arrow   = [ﬂú]
Right Arrow  = [ﬂù]
LMB          = [ﬂû]
RMB          = [ﬂü]
Shotgun      = [ﬂ∞]
Scroll Wheel = [ﬂ±]
Mouse +        = [ﬂ≤]
Hitmarker      = [ﬂ¥]
Key          = [ﬂ≥]
Party         = [ﬂµ]